% | Й
- | Е
3 | И
7 | Ц
9 | Ь
< | Я
= | А
@ | Н
F | Т
G | Щ
J | В
N | Д
R | Ы
U | С
Y | К
Z | Ж
i | Р
s | Э
Ё | Ф
Д | У
Ж | Л
И | _
Й | Ч
О | Б
П | О
Р | Е
Т | Х
Х | Г
Я | З
г | П
у | Ю
ю | М
