М - ' '
> - и
У - л
Х - н
7 - й
Е - c
4 - а
О - е
b - г
Й - х
c - д
1 - о
2 - п

 - ы
И - ф
Б - э
Д - р
r - т
5 - б
< - ч
Л - я
П - ж
8 - к
a - в
Р - з
t - у
Ы - ш
Ь - щ
А - ь
К - ю
Ф - м
Ч - ц

