= -> A
O -> Б
J -> В
X -> Г
N -> Д
P -> Е
Z -> Ж
Я -> З
3 -> И
% -> Й
Y -> К
Ж -> Л
ю -> М
@ -> Н
П -> О
у -> П
i -> Р
U -> С
F -> Т
Д -> У
Ё -> Ф
Т -> Х
7 -> Ц
Й -> Ч
G -> Щ
R -> Ы
9 -> Ь
s -> Э
y -> Ю
< -> Я
И -> " "
