 7 - пробел
G - О
= - И
N - А
ю - К
J - Т
Y - Э
Ё - Е
Т - Д
Р - Р
П - Б
Q - З
Ж - М
% - П
F - В
3 - Ж
1 - Х
U - Ц
9 - Ш
О - Я
i - Г
Д - Ё
Х - Ю
Й - Н
s - Ф
Z - Ы
R - С
И - Л
Я - Щ
у - Ч
@ - Ь
К - У
г - Й