КЛЮЧ ДЕШИФРОВКИ:
! -> Т
$ -> Е
- -> В
3 -> Э
9 -> Р
> -> З
A -> Ц
B -> Ж
C -> Я
E -> Ф
F -> Д
G -> Б
I -> Н
J -> Щ
K -> Ь
L -> У
M ->  
O -> Ч
P -> П
Q -> Х
R -> И
S -> М
U -> Г
V -> Л
W -> Ы
Y -> А
Z -> О
d -> С
h -> К
n -> Ю
t -> Й
