Р :  
1 : О
3 : И
Ё : Е
Я : А
9 : Н
@ : Т
U : С
Т : Р
Х : В
К : М
Д : Л
F : Д
N : Я
s : К
Ж : П
ю : З
П : Ы
< : Ь
% : У
Z : Ч
J : Ж
О : Г
i : Х
G : Ф
г : Й
Й : Ю
у : Б
Y : Ц
И : Ш
= : Щ
Q : Э
- : Ъ
