г	  
О	О 
Д	Т 
J	Е 
у	А 
Р	М 
<	И 
9	Ц 
Y	Р 
Я	В 
1	Н 
@	Л 
3	Д 
К	З 
R	К 
Ж	П 
U	Я 
Й	Ы 
Z	Ь 
%	У 
Q	Ч 
i	Ж 
F	Г 
N	Х 
Ё	Ф 
7	Й 
Т	Ю 
ю	Б 
И	С 
	Ш 
=	Щ 
G	Э 
s	Ъ 