Р :  
1 : О
9 : Н
К : М
3 : Е
Я : Т
N : Д
F : У
% : Ж
Ё : И 
ю : Я
s : П
Х : Р
Д : В
Z : Б
Т : Л
О : Ь
Y : Ш
U : С
г : Х
G : Ц
@ : А
i : Г
П : Ы
у : Й
Ж : К
= : 
J : З
Q : Ф
< : Ч
Й : Ю
Ф : Э
- : Щ
h : Ъ