  -> г
И -> О
О -> Д
С -> <
Л -> @
П -> R
Н -> J
Ф -> N
Д -> 3
Р -> Y
М -> 1
А -> Р
Ц -> i
Б -> Q
Е -> у
З -> Ж
Т -> 9
Ь -> F
Ю -> И
Я -> U
Щ -> ю
У -> Й
Ж -> Т
В -> Я
К -> Z
Ы -> К
Ч -> Ё
Х -> %
Г -> 7
Ъ -> =
Ш -> s
Э -> G
