Найденный ключ (построен по частотному анализу)

7  -> пробел
G  -> О
=  -> И
Й  -> Е
Ё  -> А
N  -> Н
J  -> Т
Р  -> С
R  -> Р
F  -> В
Z  -> Л
ю  -> К
О  -> М
И  -> Д
Т  -> У
Q  -> Я
s  -> Ы
Ж  -> Ь
%  -> Г
К  -> З
1  -> Б
i  -> Ч
9  -> Й
г  -> Ж
П  -> Ш
U  -> Ю
Х  -> Ц
Я  -> Щ
@  -> Э
3  -> Ф
Д  -> Ъ
Y  -> Х