КЛЮЧ ШИФРОВАНИЯ
===============
А -> к
Б -> п
В -> ж
Г -> 3
Д -> j
Е -> т
Ж -> r
З -> z
И -> и
Й -> f
К -> %
Л -> г
М -> у
Н -> й
О -> =
П -> о
Р -> 7
С -> @
Т -> х
У -> i
Ф -> д
Х -> <
Ц -> р
Ч -> 1
Ш -> ю
Щ -> y
Ъ -> s
Ы -> u
Ь -> q
Э -> ё
Ю -> я
Я -> g
ПРОБЕЛ -> n
