Шифр: Цезарь
Алфавит: АБВГДЕЁЖЗИЙКЛМНОПРСТУФХЦЧШЩЪЫЬЭЮЯ 
Сдвиг: 3
Проверка дешифрованием: успешна
Таблица замены (исходный символ -> зашифрованный):
==================================================
А -> Г
Б -> Д
В -> Е
Г -> Ё
Д -> Ж
Е -> З
Ё -> И
Ж -> Й
З -> К
И -> Л
Й -> М
К -> Н
Л -> О
М -> П
Н -> Р
О -> С
П -> Т
Р -> У
С -> Ф
Т -> Х
У -> Ц
Ф -> Ч
Х -> Ш
Ц -> Щ
Ч -> Ъ
Ш -> Ы
Щ -> Ь
Ъ -> Э
Ы -> Ю
Ь -> Я
Э ->  
Ю -> А
Я -> Б
ПРОБЕЛ -> В
